0 0 0 0 0 0 0 0 0 0 0 0 0 0 0 0 0 0 0 0 0 0 0 0 0 0 0 0 0 0 0 0 0 0 0 0 0 0 0 0 0 0 0 0 0 0 0 0 0 0 0 0 0 0 0 0 0 0 0 0 0 0 0 0 0 0 0 0 0 0 0 0 0 0 0 0 0 0 0 0 0 0 0 0 0 0 0 0 0 0 0 0 0 0 0 0 0 0 0 0 0 0 0 0 0 0 0 0 0 0 0 0 0 0 0 0 0 0 0 0 0 0 0 0 0 0 0 0 0 0 0 0 0 0 0 0 0 0 0 0 0 0 0 0 0 0 0 0 0 0 0 0 0 0 0 0 0 0 0 0 0 0 0 0 0 0 0 0 0 0 0 0 0 0 0 0 0 0 0 0 0 0 0 0 0 0 0 0 0 0 0 0 0 0 0 0 0 0 0 0 0 0 0 0 0 0 0 0 0 0 0 0 0 0 0 0 0 0 0 0 0 0 0 0 0 0 0 0 0 0 0 0 0 0 0 0 0 0 0 0 0 0 0 0 0 0 0 0 0 0 0 0 0 0 0 0 0 0 0 0 0 0 0 0 0 0 0 0 0 0 0 0 0 0 0 0 0 0 0 0 0 0 0 0 0 0 0 0 0 0 0 0 0 0 0 0 0 0 0 0 0 0 0 0 0 0 0 0 0 0 0 0 0 0 0 0 0 0 0 0 0 0 0 0 0 0 0 0 0 0 0 0 0 0 0 0 0 0 0 0 0 0 0 0 0 0 0 0 0 0 0 0 0 0 0 0 0 0 0 0 0 0 0 0 0 0 0 0 0 0 0 0 0 0 0 0 0 0 0 0 0 0 0 0 0 0 0 0 0 0 0 0 0 0 0 0 0 0 0 0 0 0 0 0 0 0 0 0 0 0 0 0 0 0 0 0 0 0 0 0 0 0 0 0 0 0 0 0 0 0 0 0 0 0 0 0 0 0 0 0 0 0 0 0 0 0 0 0 0 0 0 0 0 0 0 0 0 0 0 0 0 0 0 0 0 0 0 0 0 0 0 0 0 0 0 0 0 0 0 0 0 0 0 0 0 0 0 0 0 0 0 0 0 0 0 0 0 0 0 0 0 0 0 0 0 0 0 0 0 0 0 0 0 0 0 0 0 0 0 0 0 0 0 0 0 0 0 0 0 0 0 0 0 0 0 0 0 0 0 0 0 0 0 0 0 0 0 0 0 0 0 0 0 0 0 0 0 0 0 0 0 0 0 0 0 0 0 0 0 0 0 0 0 0 0 0 0 0 0 0 0 0 0 0 0 0 0 0 0 0 0 0 0 0 0 0 0 0 0 0 0 0 0 0 0 0 0 0 0 0 0 0 0 0 0 0 0 0 0 0 0 0 0 0 0 0 0 0 0 0 0 0 0 0 0 0 0 0 0 0 0 0 0 0 0 0 0 0 0 0 0 0 0 0 0 0 0 0 0 0 0 0 0 0 0 0 0 0 0 0 0 0 0 0 0 0 0 0 0 0 0 0 0 0 0 0 0 0 0 0 0 0 0 0 0 0 0 0 0 0 0 0 0 0 0 0 0 0 0 0 0 0 0 0 0 0 0 0 0 0 0 0 0 0 0 0 0 0 0 0 0 0 0 0 0 0 0 0 0 0 0 0 0 0 0 0 0 0 0 0 0 0 0 0 0 0 0 0 0 0 0 0 0 0 0 0 0 0 0 0 0 0 0 0 0 0 0 0 0 0 0 0 0 0 0 0 0 0 0 0 0 0 0 0 0 0 0 0 0 0
0 0 0 0 0 0 0 0 0 0 0 0 0 0 0 0 0 0 0 0 0 0 0 0 0 0 0 0 0 0 0 0 0 0 0 0 0 0 0 0 0 0 0 0 0 0 0 0 0 0 0 0 0 0 0 0 0 0 0 0 0 0 0 0 0 0 0 0 0 0 0 0 0 0 0 0 0 0 0 0 0 0 0 0 0 0 0 0 0 0 0 0 0 0 0 0 0 0 0 0 0 0 0 0 0 0 0 0 0 0 0 0 0 0 0 0 0 0 0 0 0 0 0 0 0 0 0 0 0 0 0 0 0 0 0 0 0 0 0 0 0 0 0 0 0 0 0 0 0 0 0 0 0 0 0 0 0 0 0 0 0 0 0 0 0 0 0 0 0 0 0 0 0 0 0 0 0 0 0 0 0 0 0 0 0 0 0 0 0 0 0 0 0 0 0 0 0 0 0 0 0 0 0 0 0 0 0 0 0 0 0 0 0 0 0 0 0 0 0 0 0 0 0 0 0 0 0 0 0 0 0 0 0 0 0 0 0 0 0 0 0 0 0 0 0 0 0 0 0 0 0 0 0 0 0 0 0 0 0 0 0 0 0 0 0 0 0 0 0 0 0 0 0 0 0 0 0 0 0 0 0 0 0 0 0 0 0 0 0 0 0 0 0 0 0 0 0 0 0 0 0 0 0 0 0 0 0 0 0 0 0 0 0 0 0 0 0 0 0 0 0 0 0 0 0 0 0 0 0 0 0 0 0 0 0 0 0 0 0 0 0 0 0 0 0 0 0 0 0 0 0 0 0 0 0 0 0 0 0 0 0 0 0 0 0 0 0 0 0 0 0 0 0 0 0 0 0 0 0 0 0 0 0 0 0 0 0 0 0 0 0 0 0 0 0 0 0 0 0 0 0 0 0 0 0 0 0 0 0 0 0 0 0 0 0 0 0 0 0 0 0 0 0 0 0 0 0 0 0 0 0 0 0 0 0 0 0 0 0 0 0 0 0 0 0 0 0 0 0 0 0 0 0 0 0 0 0 0 0 0 0 0 0 0 0 0 0 0 0 0 0 0 0 0 0 0 0 0 0 0 0 0 0 0 0 0 0 0 0 0 0 0 0 0 0 0 0 0 0 0 0 0 0 0 0 0 0 0 0 0 0 0 0 0 0 0 0 0 0 0 0 0 0 0 0 0 0 0 0 0 0 0 0 0 0 0 0 0 0 0 0 0 0 0 0 0 0 0 0 0 0 0 0 0 0 0 0 0 0 0 0 0 0 0 0 0 0 0 0 0 0 0 0 0 0 0 0 0 0 0 0 0 0 0 0 0 0 0 0 0 0 0 0 0 0 0 0 0 0 0 0 0 0 0 0 0 0 0 0 0 0 0 0 0 0 0 0 0 0 0 0 0 0 0 0 0 0 0 0 0 0 0 0 0 0 0 0 0 0 0 0 0 0 0 0 0 0 0 0 0 0 0 0 0 0 0 0 0 0 0 0 0 0 0 0 0 0 0 0 0 0 0 0 0 0 0 0 0 0 0 0 0 0 0 0 0 0 0 0 0 0 0 0 0 0 0 0 0 0 0 0 0 0 0 0 0 0 0 0 0 0 0 0 0 0 0 0 0 0 0 0 0 0 0 0 0 0 0 0 0 0 0 0 0 0 0 0 0 0 0 0 0 0 0 0 0 0 0 0 0 0 0 0 0 0 0 0 0 0 0 0 0 0 0 0 0 0 0 0 0 0 0 0 0 0 0 0 0 0 0 0 0 0 0 0 0 0 0 0 0 0 0 0 0 0 0 0 0 0 0
0 0 0 0 0 0 0 0 0 0 0 0 0 0 13 15 17 19 21 23 0 0 0 0 0 0 0 0 0 0 0 0 0 0 0 0 0 0 13 15 17 19 21 23 0 0 0 0 0 0 0 0 0 0 0 0 0 0 0 0 0 0 0 0 13 15 17 19 21 23 0 0 0 0 0 0 0 0 0 0 0 0 0 0 0 0 0 0 13 15 17 19 21 23 0 0 0 0 0 0 0 0 0 0 0 0 0 0 0 0 0 0 0 0 13 15 17 19 21 23 0 0 0 0 0 0 0 0 0 0 0 0 0 0 0 0 0 0 13 15 17 19 21 23 0 0 0 0 0 0 0 0 0 0 0 0 0 0 0 0 0 0 0 0 13 15 17 19 21 23 0 0 0 0 0 0 0 0 0 0 0 0 0 0 0 0 0 0 13 15 17 19 21 23 0 0 0 0 0 0 0 0 0 0 0 0 0 0 0 0 0 0 0 0 13 15 17 19 21 23 0 0 0 0 0 0 0 0 0 0 0 0 0 0 0 0 0 0 13 15 17 19 21 23 0 0 0 0 0 0 0 0 0 0 0 0 0 0 0 0 0 0 0 0 13 15 17 19 21 23 0 0 0 0 0 0 0 0 0 0 0 0 0 0 0 0 0 0 13 15 17 19 21 23 0 0 0 0 0 0 0 0 0 0 0 0 0 0 0 0 0 0 0 0 13 15 17 19 21 23 0 0 0 0 0 0 0 0 0 0 0 0 0 0 0 0 0 0 13 15 17 19 21 23 0 0 0 0 0 0 0 0 0 0 0 0 0 0 0 0 0 0 0 0 13 15 17 19 21 23 0 0 0 0 0 0 0 0 0 0 0 0 0 0 0 0 0 0 13 15 17 19 21 23 0 0 0 0 0 0 0 0 0 0 0 0 0 0 0 0 0 0 0 0 13 15 17 19 21 23 0 0 0 0 0 0 0 0 0 0 0 0 0 0 0 0 0 0 13 15 17 19 21 23 0 0 0 0 0 0 0 0 0 0 0 0 0 0 0 0 0 0 0 0 13 15 17 19 21 23 0 0 0 0 0 0 0 0 0 0 0 0 0 0 0 0 0 0 13 15 17 19 21 23 0 0 0 0 0 0 0 0 0 0 0 0 0 0 0 0 0 0 0 0 13 15 17 19 21 23 0 0 0 0 0 0 0 0 0 0 0 0 0 0 0 0 0 0 13 15 17 19 21 23 0 0 0 0 0 0 0 0 0 0 0 0 0 0 0 0 0 0 0 0 13 15 17 19 21 23 0 0 0 0 0 0 0 0 0 0 0 0 0 0 0 0 0 0 13 15 17 19 21 23 0 0 0 0 0 0 0 0 0 0 0 0 0 0 0 0 0 0 0 0 13 15 17 19 21 23 0 0 0 0 0 0 0 0 0 0 0 0 0 0 0 0 0 0 13 15 17 19 21 23 0 0 0 0 0 0 0 0 0 0 0 0 0 0 0 0 0 0 0 0 13 15 17 19 21 23 0 0 0 0 0 0 0 0 0 0 0 0 0 0 0 0 0 0 13 15 17 19 21 23 0 0 0 0 0 0 0 0 0 0 0 0 0 0 0 0 0 0 0 0 13 15 17 19 21 23 0 0 0 0 0 0 0 0 0 0 0 0 0 0 0 0 0 0 13 15 17 19 21 23 0 0 0 0 0 0 0 0 0 0 0 0 0 0 0 0 0 0 0 0 13 15 17 19 21 23 0 0 0 0 0 0 0 0 0 0 0 0 0 0 0 0 0 0 13 15 17 19 21 23 0 0 0 0 0 0
0 0 0 0 0 0 0 0 0 0 0 0 0 0 14 16 18 20 22 24 0 0 0 0 0 0 0 0 0 0 0 0 0 0 0 0 0 0 14 16 18 20 22 24 0 0 0 0 0 0 0 0 0 0 0 0 0 0 0 0 0 0 0 0 14 16 18 20 22 24 0 0 0 0 0 0 0 0 0 0 0 0 0 0 0 0 0 0 14 16 18 20 22 24 0 0 0 0 0 0 0 0 0 0 0 0 0 0 0 0 0 0 0 0 14 16 18 20 22 24 0 0 0 0 0 0 0 0 0 0 0 0 0 0 0 0 0 0 14 16 18 20 22 24 0 0 0 0 0 0 0 0 0 0 0 0 0 0 0 0 0 0 0 0 14 16 18 20 22 24 0 0 0 0 0 0 0 0 0 0 0 0 0 0 0 0 0 0 14 16 18 20 22 24 0 0 0 0 0 0 0 0 0 0 0 0 0 0 0 0 0 0 0 0 14 16 18 20 22 24 0 0 0 0 0 0 0 0 0 0 0 0 0 0 0 0 0 0 14 16 18 20 22 24 0 0 0 0 0 0 0 0 0 0 0 0 0 0 0 0 0 0 0 0 14 16 18 20 22 24 0 0 0 0 0 0 0 0 0 0 0 0 0 0 0 0 0 0 14 16 18 20 22 24 0 0 0 0 0 0 0 0 0 0 0 0 0 0 0 0 0 0 0 0 14 16 18 20 22 24 0 0 0 0 0 0 0 0 0 0 0 0 0 0 0 0 0 0 14 16 18 20 22 24 0 0 0 0 0 0 0 0 0 0 0 0 0 0 0 0 0 0 0 0 14 16 18 20 22 24 0 0 0 0 0 0 0 0 0 0 0 0 0 0 0 0 0 0 14 16 18 20 22 24 0 0 0 0 0 0 0 0 0 0 0 0 0 0 0 0 0 0 0 0 14 16 18 20 22 24 0 0 0 0 0 0 0 0 0 0 0 0 0 0 0 0 0 0 14 16 18 20 22 24 0 0 0 0 0 0 0 0 0 0 0 0 0 0 0 0 0 0 0 0 14 16 18 20 22 24 0 0 0 0 0 0 0 0 0 0 0 0 0 0 0 0 0 0 14 16 18 20 22 24 0 0 0 0 0 0 0 0 0 0 0 0 0 0 0 0 0 0 0 0 14 16 18 20 22 24 0 0 0 0 0 0 0 0 0 0 0 0 0 0 0 0 0 0 14 16 18 20 22 24 0 0 0 0 0 0 0 0 0 0 0 0 0 0 0 0 0 0 0 0 14 16 18 20 22 24 0 0 0 0 0 0 0 0 0 0 0 0 0 0 0 0 0 0 14 16 18 20 22 24 0 0 0 0 0 0 0 0 0 0 0 0 0 0 0 0 0 0 0 0 14 16 18 20 22 24 0 0 0 0 0 0 0 0 0 0 0 0 0 0 0 0 0 0 14 16 18 20 22 24 0 0 0 0 0 0 0 0 0 0 0 0 0 0 0 0 0 0 0 0 14 16 18 20 22 24 0 0 0 0 0 0 0 0 0 0 0 0 0 0 0 0 0 0 14 16 18 20 22 24 0 0 0 0 0 0 0 0 0 0 0 0 0 0 0 0 0 0 0 0 14 16 18 20 22 24 0 0 0 0 0 0 0 0 0 0 0 0 0 0 0 0 0 0 14 16 18 20 22 24 0 0 0 0 0 0 0 0 0 0 0 0 0 0 0 0 0 0 0 0 14 16 18 20 22 24 0 0 0 0 0 0 0 0 0 0 0 0 0 0 0 0 0 0 14 16 18 20 22 24 0 0 0 0 0 0
0 0 0 0 13 15 17 19 21 23 0 0 0 0 0 0 0 0 0 0 0 0 0 0 0 0 0 0 13 15 17 19 21 23 0 0 0 0 0 0 0 0 0 0 0 0 0 0 0 0 0 0 0 0 13 15 17 19 21 23 0 0 0 0 0 0 0 0 0 0 0 0 0 0 0 0 0 0 13 15 17 19 21 23 0 0 0 0 0 0 0 0 0 0 0 0 0 0 0 0 0 0 0 0 13 15 17 19 21 23 0 0 0 0 0 0 0 0 0 0 0 0 0 0 0 0 0 0 13 15 17 19 21 23 0 0 0 0 0 0 0 0 0 0 0 0 0 0 0 0 0 0 0 0 13 15 17 19 21 23 0 0 0 0 0 0 0 0 0 0 0 0 0 0 0 0 0 0 13 15 17 19 21 23 0 0 0 0 0 0 0 0 0 0 0 0 0 0 0 0 0 0 0 0 13 15 17 19 21 23 0 0 0 0 0 0 0 0 0 0 0 0 0 0 0 0 0 0 13 15 17 19 21 23 0 0 0 0 0 0 0 0 0 0 0 0 0 0 0 0 0 0 0 0 13 15 17 19 21 23 0 0 0 0 0 0 0 0 0 0 0 0 0 0 0 0 0 0 13 15 17 19 21 23 0 0 0 0 0 0 0 0 0 0 0 0 0 0 0 0 0 0 0 0 13 15 17 19 21 23 0 0 0 0 0 0 0 0 0 0 0 0 0 0 0 0 0 0 13 15 17 19 21 23 0 0 0 0 0 0 0 0 0 0 0 0 0 0 0 0 0 0 0 0 13 15 17 19 21 23 0 0 0 0 0 0 0 0 0 0 0 0 0 0 0 0 0 0 13 15 17 19 21 23 0 0 0 0 0 0 0 0 0 0 0 0 0 0 0 0 0 0 0 0 13 15 17 19 21 23 0 0 0 0 0 0 0 0 0 0 0 0 0 0 0 0 0 0 13 15 17 19 21 23 0 0 0 0 0 0 0 0 0 0 0 0 0 0 0 0 0 0 0 0 13 15 17 19 21 23 0 0 0 0 0 0 0 0 0 0 0 0 0 0 0 0 0 0 13 15 17 19 21 23 0 0 0 0 0 0 0 0 0 0 0 0 0 0 0 0 0 0 0 0 13 15 17 19 21 23 0 0 0 0 0 0 0 0 0 0 0 0 0 0 0 0 0 0 13 15 17 19 21 23 0 0 0 0 0 0 0 0 0 0 0 0 0 0 0 0 0 0 0 0 13 15 17 19 21 23 0 0 0 0 0 0 0 0 0 0 0 0 0 0 0 0 0 0 13 15 17 19 21 23 0 0 0 0 0 0 0 0 0 0 0 0 0 0 0 0 0 0 0 0 13 15 17 19 21 23 0 0 0 0 0 0 0 0 0 0 0 0 0 0 0 0 0 0 13 15 17 19 21 23 0 0 0 0 0 0 0 0 0 0 0 0 0 0 0 0 0 0 0 0 13 15 17 19 21 23 0 0 0 0 0 0 0 0 0 0 0 0 0 0 0 0 0 0 13 15 17 19 21 23 0 0 0 0 0 0 0 0 0 0 0 0 0 0 0 0 0 0 0 0 13 15 17 19 21 23 0 0 0 0 0 0 0 0 0 0 0 0 0 0 0 0 0 0 13 15 17 19 21 23 0 0 0 0 0 0 0 0 0 0 0 0 0 0 0 0 0 0 0 0 13 15 17 19 21 23 0 0 0 0 0 0 0 0 0 0 0 0 0 0 0 0 0 0 13 15 17 19 21 23 0 0 0 0 0 0 0 0 0 0 0 0 0 0 0 0
0 0 0 0 14 16 18 20 22 24 0 0 0 0 0 0 0 0 0 0 0 0 0 0 0 0 0 0 14 16 18 20 22 24 0 0 0 0 0 0 0 0 0 0 0 0 0 0 0 0 0 0 0 0 14 16 18 20 22 24 0 0 0 0 0 0 0 0 0 0 0 0 0 0 0 0 0 0 14 16 18 20 22 24 0 0 0 0 0 0 0 0 0 0 0 0 0 0 0 0 0 0 0 0 14 16 18 20 22 24 0 0 0 0 0 0 0 0 0 0 0 0 0 0 0 0 0 0 14 16 18 20 22 24 0 0 0 0 0 0 0 0 0 0 0 0 0 0 0 0 0 0 0 0 14 16 18 20 22 24 0 0 0 0 0 0 0 0 0 0 0 0 0 0 0 0 0 0 14 16 18 20 22 24 0 0 0 0 0 0 0 0 0 0 0 0 0 0 0 0 0 0 0 0 14 16 18 20 22 24 0 0 0 0 0 0 0 0 0 0 0 0 0 0 0 0 0 0 14 16 18 20 22 24 0 0 0 0 0 0 0 0 0 0 0 0 0 0 0 0 0 0 0 0 14 16 18 20 22 24 0 0 0 0 0 0 0 0 0 0 0 0 0 0 0 0 0 0 14 16 18 20 22 24 0 0 0 0 0 0 0 0 0 0 0 0 0 0 0 0 0 0 0 0 14 16 18 20 22 24 0 0 0 0 0 0 0 0 0 0 0 0 0 0 0 0 0 0 14 16 18 20 22 24 0 0 0 0 0 0 0 0 0 0 0 0 0 0 0 0 0 0 0 0 14 16 18 20 22 24 0 0 0 0 0 0 0 0 0 0 0 0 0 0 0 0 0 0 14 16 18 20 22 24 0 0 0 0 0 0 0 0 0 0 0 0 0 0 0 0 0 0 0 0 14 16 18 20 22 24 0 0 0 0 0 0 0 0 0 0 0 0 0 0 0 0 0 0 14 16 18 20 22 24 0 0 0 0 0 0 0 0 0 0 0 0 0 0 0 0 0 0 0 0 14 16 18 20 22 24 0 0 0 0 0 0 0 0 0 0 0 0 0 0 0 0 0 0 14 16 18 20 22 24 0 0 0 0 0 0 0 0 0 0 0 0 0 0 0 0 0 0 0 0 14 16 18 20 22 24 0 0 0 0 0 0 0 0 0 0 0 0 0 0 0 0 0 0 14 16 18 20 22 24 0 0 0 0 0 0 0 0 0 0 0 0 0 0 0 0 0 0 0 0 14 16 18 20 22 24 0 0 0 0 0 0 0 0 0 0 0 0 0 0 0 0 0 0 14 16 18 20 22 24 0 0 0 0 0 0 0 0 0 0 0 0 0 0 0 0 0 0 0 0 14 16 18 20 22 24 0 0 0 0 0 0 0 0 0 0 0 0 0 0 0 0 0 0 14 16 18 20 22 24 0 0 0 0 0 0 0 0 0 0 0 0 0 0 0 0 0 0 0 0 14 16 18 20 22 24 0 0 0 0 0 0 0 0 0 0 0 0 0 0 0 0 0 0 14 16 18 20 22 24 0 0 0 0 0 0 0 0 0 0 0 0 0 0 0 0 0 0 0 0 14 16 18 20 22 24 0 0 0 0 0 0 0 0 0 0 0 0 0 0 0 0 0 0 14 16 18 20 22 24 0 0 0 0 0 0 0 0 0 0 0 0 0 0 0 0 0 0 0 0 14 16 18 20 22 24 0 0 0 0 0 0 0 0 0 0 0 0 0 0 0 0 0 0 14 16 18 20 22 24 0 0 0 0 0 0 0 0 0 0 0 0 0 0 0 0
0 0 0 0 0 0 0 0 0 0 0 0 0 0 0 0 0 0 0 0 0 0 0 0 0 0 0 0 0 0 0 0 0 0 0 0 0 0 0 0 0 0 0 0 0 0 0 0 0 0 0 0 0 0 0 0 0 0 0 0 0 0 0 0 0 0 0 0 0 0 0 0 0 0 0 0 0 0 0 0 0 0 0 0 0 0 0 0 0 0 0 0 0 0 0 0 0 0 0 0 0 0 0 0 0 0 0 0 0 0 0 0 0 0 0 0 0 0 0 0 0 0 0 0 0 0 0 0 0 0 0 0 0 0 0 0 0 0 0 0 0 0 0 0 0 0 0 0 0 0 0 0 0 0 0 0 0 0 0 0 0 0 0 0 0 0 0 0 0 0 0 0 0 0 0 0 0 0 0 0 0 0 0 0 0 0 0 0 0 0 0 0 0 0 0 0 0 0 0 0 0 0 0 0 0 0 0 0 0 0 0 0 0 0 0 0 0 0 0 0 0 0 0 0 0 0 0 0 0 0 0 0 0 0 0 0 0 0 0 0 0 0 0 0 0 0 0 0 0 0 0 0 0 0 0 0 0 0 0 0 0 0 0 0 0 0 0 0 0 0 0 0 0 0 0 0 0 0 0 0 0 0 0 0 0 0 0 0 0 0 0 0 0 0 0 0 0 0 0 0 0 0 0 0 0 0 0 0 0 0 0 0 0 0 0 0 0 0 0 0 0 0 0 0 0 0 0 0 0 0 0 0 0 0 0 0 0 0 0 0 0 0 0 0 0 0 0 0 0 0 0 0 0 0 0 0 0 0 0 0 0 0 0 0 0 0 0 0 0 0 0 0 0 0 0 0 0 0 0 0 0 0 0 0 0 0 0 0 0 0 0 0 0 0 0 0 0 0 0 0 0 0 0 0 0 0 0 0 0 0 0 0 0 0 0 0 0 0 0 0 0 0 0 0 0 0 0 0 0 0 0 0 0 0 0 0 0 0 0 0 0 0 0 0 0 0 0 0 0 0 0 0 0 0 0 0 0 0 0 0 0 0 0 0 0 0 0 0 0 0 0 0 0 0 0 0 0 0 0 0 0 0 0 0 0 0 0 0 0 0 0 0 0 0 0 0 0 0 0 0 0 0 0 0 0 0 0 0 0 0 0 0 0 0 0 0 0 0 0 0 0 0 0 0 0 0 0 0 0 0 0 0 0 0 0 0 0 0 0 0 0 0 0 0 0 0 0 0 0 0 0 0 0 0 0 0 0 0 0 0 0 0 0 0 0 0 0 0 0 0 0 0 0 0 0 0 0 0 0 0 0 0 0 0 0 0 0 0 0 0 0 0 0 0 0 0 0 0 0 0 0 0 0 0 0 0 0 0 0 0 0 0 0 0 0 0 0 0 0 0 0 0 0 0 0 0 0 0 0 0 0 0 0 0 0 0 0 0 0 0 0 0 0 0 0 0 0 0 0 0 0 0 0 0 0 0 0 0 0 0 0 0 0 0 0 0 0 0 0 0 0 0 0 0 0 0 0 0 0 0 0 0 0 0 0 0 0 0 0 0 0 0 0 0 0 0 0 0 0 0 0 0 0 0 0 0 0 0 0 0 0 0 0 0 0 0 0 0 0 0 0 0 0 0 0 0 0 0 0 0 0 0 0 0 0 0 0 0 0 0 0 0 0 0 0 0 0 0 0 0 0 0 0 0 0 0 0 0 0 0 0 0 0 0 0 0 0 0 0 0 0 0 0 0 0 0 0 0 0 0 0 0 0 0 0 0 0 0 0 0 0 0 0 0 0 0 0 0 0 0
0 0 0 0 0 0 0 0 0 0 0 0 0 0 0 0 0 0 0 0 0 0 0 0 0 0 0 0 0 0 0 0 0 0 0 0 0 0 0 0 0 0 0 0 0 0 0 0 0 0 0 0 0 0 0 0 0 0 0 0 0 0 0 0 0 0 0 0 0 0 0 0 0 0 0 0 0 0 0 0 0 0 0 0 0 0 0 0 0 0 0 0 0 0 0 0 0 0 0 0 0 0 0 0 0 0 0 0 0 0 0 0 0 0 0 0 0 0 0 0 0 0 0 0 0 0 0 0 0 0 0 0 0 0 0 0 0 0 0 0 0 0 0 0 0 0 0 0 0 0 0 0 0 0 0 0 0 0 0 0 0 0 0 0 0 0 0 0 0 0 0 0 0 0 0 0 0 0 0 0 0 0 0 0 0 0 0 0 0 0 0 0 0 0 0 0 0 0 0 0 0 0 0 0 0 0 0 0 0 0 0 0 0 0 0 0 0 0 0 0 0 0 0 0 0 0 0 0 0 0 0 0 0 0 0 0 0 0 0 0 0 0 0 0 0 0 0 0 0 0 0 0 0 0 0 0 0 0 0 0 0 0 0 0 0 0 0 0 0 0 0 0 0 0 0 0 0 0 0 0 0 0 0 0 0 0 0 0 0 0 0 0 0 0 0 0 0 0 0 0 0 0 0 0 0 0 0 0 0 0 0 0 0 0 0 0 0 0 0 0 0 0 0 0 0 0 0 0 0 0 0 0 0 0 0 0 0 0 0 0 0 0 0 0 0 0 0 0 0 0 0 0 0 0 0 0 0 0 0 0 0 0 0 0 0 0 0 0 0 0 0 0 0 0 0 0 0 0 0 0 0 0 0 0 0 0 0 0 0 0 0 0 0 0 0 0 0 0 0 0 0 0 0 0 0 0 0 0 0 0 0 0 0 0 0 0 0 0 0 0 0 0 0 0 0 0 0 0 0 0 0 0 0 0 0 0 0 0 0 0 0 0 0 0 0 0 0 0 0 0 0 0 0 0 0 0 0 0 0 0 0 0 0 0 0 0 0 0 0 0 0 0 0 0 0 0 0 0 0 0 0 0 0 0 0 0 0 0 0 0 0 0 0 0 0 0 0 0 0 0 0 0 0 0 0 0 0 0 0 0 0 0 0 0 0 0 0 0 0 0 0 0 0 0 0 0 0 0 0 0 0 0 0 0 0 0 0 0 0 0 0 0 0 0 0 0 0 0 0 0 0 0 0 0 0 0 0 0 0 0 0 0 0 0 0 0 0 0 0 0 0 0 0 0 0 0 0 0 0 0 0 0 0 0 0 0 0 0 0 0 0 0 0 0 0 0 0 0 0 0 0 0 0 0 0 0 0 0 0 0 0 0 0 0 0 0 0 0 0 0 0 0 0 0 0 0 0 0 0 0 0 0 0 0 0 0 0 0 0 0 0 0 0 0 0 0 0 0 0 0 0 0 0 0 0 0 0 0 0 0 0 0 0 0 0 0 0 0 0 0 0 0 0 0 0 0 0 0 0 0 0 0 0 0 0 0 0 0 0 0 0 0 0 0 0 0 0 0 0 0 0 0 0 0 0 0 0 0 0 0 0 0 0 0 0 0 0 0 0 0 0 0 0 0 0 0 0 0 0 0 0 0 0 0 0 0 0 0 0 0 0 0 0 0 0 0 0 0 0 0 0 0 0 0 0 0 0 0 0 0 0 0 0 0 0 0 0 0 0 0 0 0 0 0 0 0 0 0 0 0 0 0 0 0 0 0 0 0 0 0 0 0 0 0 0 0 0 0 0 0
0 0 0 0 0 0 0 0 0 0 0 0 0 0 0 0 0 0 0 0 0 0 0 0 0 0 0 0 0 0 0 0 0 0 0 0 0 0 0 0 0 0 0 0 0 0 0 0 0 0 0 0 0 0 0 0 0 0 0 0 0 0 0 0 0 0 0 0 0 0 0 0 0 0 0 0 0 0 0 0 0 0 0 0 0 0 0 0 0 0 0 0 0 0 0 0 0 0 0 0 0 0 0 0 0 0 0 0 0 0 0 0 0 0 0 0 0 0 0 0 0 0 0 0 0 0 0 0 0 0 0 0 0 0 0 0 0 0 0 0 0 0 0 0 0 0 0 0 0 0 0 0 0 0 0 0 0 0 0 0 0 0 0 0 0 0 0 0 0 0 0 0 0 0 0 0 0 0 0 0 0 0 0 0 0 0 0 0 0 0 0 0 0 0 0 0 0 0 0 0 0 0 0 0 0 0 0 0 0 0 0 0 0 0 0 0 0 0 0 0 0 0 0 0 0 0 0 0 0 0 0 0 0 0 0 0 0 0 0 0 0 0 0 0 0 0 0 0 0 0 0 0 0 0 0 0 0 0 0 0 0 0 0 0 0 0 0 0 0 0 0 0 0 0 0 0 0 0 0 0 0 0 0 0 0 0 0 0 0 0 0 0 0 0 0 0 0 0 0 0 0 0 0 0 0 0 0 0 0 0 0 0 0 0 0 0 0 0 0 0 0 0 0 0 0 0 0 0 0 0 0 0 0 0 0 0 0 0 0 0 0 0 0 0 0 0 0 0 0 0 0 0 0 0 0 0 0 0 0 0 0 0 0 0 0 0 0 0 0 0 0 0 0 0 0 0 0 0 0 0 0 0 0 0 0 0 0 0 0 0 0 0 0 0 0 0 0 0 0 0 0 0 0 0 0 0 0 0 0 0 0 0 0 0 0 0 0 0 0 0 0 0 0 0 0 0 0 0 0 0 0 0 0 0 0 0 0 0 0 0 0 0 0 0 0 0 0 0 0 0 0 0 0 0 0 0 0 0 0 0 0 0 0 0 0 0 0 0 0 0 0 0 0 0 0 0 0 0 0 0 0 0 0 0 0 0 0 0 0 0 0 0 0 0 0 0 0 0 0 0 0 0 0 0 0 0 0 0 0 0 0 0 0 0 0 0 0 0 0 0 0 0 0 0 0 0 0 0 0 0 0 0 0 0 0 0 0 0 0 0 0 0 0 0 0 0 0 0 0 0 0 0 0 0 0 0 0 0 0 0 0 0 0 0 0 0 0 0 0 0 0 0 0 0 0 0 0 0 0 0 0 0 0 0 0 0 0 0 0 0 0 0 0 0 0 0 0 0 0 0 0 0 0 0 0 0 0 0 0 0 0 0 0 0 0 0 0 0 0 0 0 0 0 0 0 0 0 0 0 0 0 0 0 0 0 0 0 0 0 0 0 0 0 0 0 0 0 0 0 0 0 0 0 0 0 0 0 0 0 0 0 0 0 0 0 0 0 0 0 0 0 0 0 0 0 0 0 0 0 0 0 0 0 0 0 0 0 0 0 0 0 0 0 0 0 0 0 0 0 0 0 0 0 0 0 0 0 0 0 0 0 0 0 0 0 0 0 0 0 0 0 0 0 0 0 0 0 0 0 0 0 0 0 0 0 0 0 0 0 0 0 0 0 0 0 0 0 0 0 0 0 0 0 0 0 0 0 0 0 0 0 0 0 0 0 0 0 0 0 0 0 0 0 0 0 0 0 0 0 0 0 0 0 0 0 0 0 0 0 0 0 0 0 0 0 0 0 0 0 0
0 0 0 0 0 0 0 0 0 0 1 2 0 0 1 2 0 0 0 0 0 1 2 1 2 0 0 0 1 2 0 0 0 1 2 1 2 0 0 0 1 2 0 0 1 2 0 1 2 0 0 0 0 1 2 0 0 1 2 0 0 0 0 0 1 2 1 2 0 0 0 1 2 0 0 0 1 2 1 2 0 0 0 1 2 0 0 1 2 0 1 2 0 0 0 0 1 2 0 0 0 0 0 0 0 0 0 0 0 0 1 2 0 0 1 2 0 0 0 0 0 1 2 1 2 0 0 0 1 2 0 0 0 1 2 1 2 0 0 0 1 2 0 0 1 2 0 1 2 0 0 0 0 1 2 0 0 1 2 0 0 0 0 0 1 2 1 2 0 0 0 1 2 0 0 0 1 2 1 2 0 0 0 1 2 0 0 1 2 0 1 2 0 0 0 0 1 2 0 0 0 0 0 0 0 0 0 0 0 0 1 2 0 0 1 2 0 0 0 0 0 1 2 1 2 0 0 0 1 2 0 0 0 1 2 1 2 0 0 0 1 2 0 0 1 2 0 1 2 0 0 0 0 1 2 0 0 1 2 0 0 0 0 0 1 2 1 2 0 0 0 1 2 0 0 0 1 2 1 2 0 0 0 1 2 0 0 1 2 0 1 2 0 0 0 0 1 2 0 0 0 0 0 0 0 0 0 0 0 0 1 2 0 0 1 2 0 0 0 0 0 1 2 1 2 0 0 0 1 2 0 0 0 1 2 1 2 0 0 0 1 2 0 0 1 2 0 1 2 0 0 0 0 1 2 0 0 1 2 0 0 0 0 0 1 2 1 2 0 0 0 1 2 0 0 0 1 2 1 2 0 0 0 1 2 0 0 1 2 0 1 2 0 0 0 0 1 2 0 0 0 0 0 0 0 0 0 0 0 0 1 2 0 0 1 2 0 0 0 0 0 1 2 1 2 0 0 0 1 2 0 0 0 1 2 1 2 0 0 0 1 2 0 0 1 2 0 1 2 0 0 0 0 1 2 0 0 1 2 0 0 0 0 0 1 2 1 2 0 0 0 1 2 0 0 0 1 2 1 2 0 0 0 1 2 0 0 1 2 0 1 2 0 0 0 0 1 2 0 0 0 0 0 0 0 0 0 0 0 0 1 2 0 0 1 2 0 0 0 0 0 1 2 1 2 0 0 0 1 2 0 0 0 1 2 1 2 0 0 0 1 2 0 0 1 2 0 1 2 0 0 0 0 1 2 0 0 1 2 0 0 0 0 0 1 2 1 2 0 0 0 1 2 0 0 0 1 2 1 2 0 0 0 1 2 0 0 1 2 0 1 2 0 0 0 0 1 2 0 0 0 0 0 0 0 0 0 0 0 0 1 2 0 0 1 2 0 0 0 0 0 1 2 1 2 0 0 0 1 2 0 0 0 1 2 1 2 0 0 0 1 2 0 0 1 2 0 1 2 0 0 0 0 1 2 0 0 1 2 0 0 0 0 0 1 2 1 2 0 0 0 1 2 0 0 0 1 2 1 2 0 0 0 1 2 0 0 1 2 0 1 2 0 0 0 0 1 2 0 0 0 0 0 0 0 0 0 0 0 0 1 2 0 0 1 2 0 0 0 0 0 1 2 1 2 0 0 0 1 2 0 0 0 1 2 1 2 0 0 0 1 2 0 0 1 2 0 1 2 0 0 0 0 1 2 0 0 1 2 0 0 0 0 0 1 2 1 2 0 0 0 1 2 0 0 0 1 2 1 2 0 0 0 1 2 0 0 1 2 0 1 2 0 0 0 0 1 2 0 0
0 0 0 0 0 0 0 0 0 0 3 4 0 0 3 4 0 0 0 0 0 3 4 3 4 0 0 0 3 4 0 0 0 3 4 3 4 0 0 0 3 4 0 0 3 4 0 3 4 0 0 0 0 3 4 0 0 3 4 0 0 0 0 0 3 4 3 4 0 0 0 3 4 0 0 0 3 4 3 4 0 0 0 3 4 0 0 3 4 0 3 4 0 0 0 0 3 4 0 0 0 0 0 0 0 0 0 0 0 0 3 4 0 0 3 4 0 0 0 0 0 3 4 3 4 0 0 0 3 4 0 0 0 3 4 3 4 0 0 0 3 4 0 0 3 4 0 3 4 0 0 0 0 3 4 0 0 3 4 0 0 0 0 0 3 4 3 4 0 0 0 3 4 0 0 0 3 4 3 4 0 0 0 3 4 0 0 3 4 0 3 4 0 0 0 0 3 4 0 0 0 0 0 0 0 0 0 0 0 0 3 4 0 0 3 4 0 0 0 0 0 3 4 3 4 0 0 0 3 4 0 0 0 3 4 3 4 0 0 0 3 4 0 0 3 4 0 3 4 0 0 0 0 3 4 0 0 3 4 0 0 0 0 0 3 4 3 4 0 0 0 3 4 0 0 0 3 4 3 4 0 0 0 3 4 0 0 3 4 0 3 4 0 0 0 0 3 4 0 0 0 0 0 0 0 0 0 0 0 0 3 4 0 0 3 4 0 0 0 0 0 3 4 3 4 0 0 0 3 4 0 0 0 3 4 3 4 0 0 0 3 4 0 0 3 4 0 3 4 0 0 0 0 3 4 0 0 3 4 0 0 0 0 0 3 4 3 4 0 0 0 3 4 0 0 0 3 4 3 4 0 0 0 3 4 0 0 3 4 0 3 4 0 0 0 0 3 4 0 0 0 0 0 0 0 0 0 0 0 0 3 4 0 0 3 4 0 0 0 0 0 3 4 3 4 0 0 0 3 4 0 0 0 3 4 3 4 0 0 0 3 4 0 0 3 4 0 3 4 0 0 0 0 3 4 0 0 3 4 0 0 0 0 0 3 4 3 4 0 0 0 3 4 0 0 0 3 4 3 4 0 0 0 3 4 0 0 3 4 0 3 4 0 0 0 0 3 4 0 0 0 0 0 0 0 0 0 0 0 0 3 4 0 0 3 4 0 0 0 0 0 3 4 3 4 0 0 0 3 4 0 0 0 3 4 3 4 0 0 0 3 4 0 0 3 4 0 3 4 0 0 0 0 3 4 0 0 3 4 0 0 0 0 0 3 4 3 4 0 0 0 3 4 0 0 0 3 4 3 4 0 0 0 3 4 0 0 3 4 0 3 4 0 0 0 0 3 4 0 0 0 0 0 0 0 0 0 0 0 0 3 4 0 0 3 4 0 0 0 0 0 3 4 3 4 0 0 0 3 4 0 0 0 3 4 3 4 0 0 0 3 4 0 0 3 4 0 3 4 0 0 0 0 3 4 0 0 3 4 0 0 0 0 0 3 4 3 4 0 0 0 3 4 0 0 0 3 4 3 4 0 0 0 3 4 0 0 3 4 0 3 4 0 0 0 0 3 4 0 0 0 0 0 0 0 0 0 0 0 0 3 4 0 0 3 4 0 0 0 0 0 3 4 3 4 0 0 0 3 4 0 0 0 3 4 3 4 0 0 0 3 4 0 0 3 4 0 3 4 0 0 0 0 3 4 0 0 3 4 0 0 0 0 0 3 4 3 4 0 0 0 3 4 0 0 0 3 4 3 4 0 0 0 3 4 0 0 3 4 0 3 4 0 0 0 0 3 4 0 0
5 5 5 5 5 5 5 5 5 5 5 5 5 5 5 5 5 5 5 5 5 5 5 5 5 5 5 5 5 5 5 5 5 5 5 5 5 5 5 5 5 5 5 5 5 5 5 5 5 5 5 5 5 5 5 5 5 5 5 5 5 5 5 5 5 5 5 5 5 5 5 5 5 5 5 5 5 5 5 5 5 5 5 5 5 5 5 5 5 5 5 5 5 5 5 5 5 5 5 5 5 5 5 5 5 5 5 5 5 5 5 5 5 5 5 5 5 5 5 5 5 5 5 5 5 5 5 5 5 5 5 5 5 5 5 5 5 5 5 5 5 5 5 5 5 5 5 5 5 5 5 5 5 5 5 5 5 5 5 5 5 5 5 5 5 5 5 5 5 5 5 5 5 5 5 5 5 5 5 5 5 5 5 5 5 5 5 5 5 5 5 5 5 5 5 5 5 5 5 5 5 5 5 5 5 5 5 5 5 5 5 5 5 5 5 5 5 5 5 5 5 5 5 5 5 5 5 5 5 5 5 5 5 5 5 5 5 5 5 5 5 5 5 5 5 5 5 5 5 5 5 5 5 5 5 5 5 5 5 5 5 5 5 5 5 5 5 5 5 5 5 5 5 5 5 5 5 5 5 5 5 5 5 5 5 5 5 5 5 5 5 5 5 5 5 5 5 5 5 5 5 5 5 5 5 5 5 5 5 5 5 5 5 5 5 5 5 5 5 5 5 5 5 5 5 5 5 5 5 5 5 5 5 5 5 5 5 5 5 5 5 5 5 5 5 5 5 5 5 5 5 5 5 5 5 5 5 5 5 5 5 5 5 5 5 5 5 5 5 5 5 5 5 5 5 5 5 5 5 5 5 5 5 5 5 5 5 5 5 5 5 5 5 5 5 5 5 5 5 5 5 5 5 5 5 5 5 5 5 5 5 5 5 5 5 5 5 5 5 5 5 5 5 5 5 5 5 5 5 5 5 5 5 5 5 5 5 5 5 5 5 5 5 5 5 5 5 5 5 5 5 5 5 5 5 5 5 5 5 5 5 5 5 5 5 5 5 5 5 5 5 5 5 5 5 5 5 5 5 5 5 5 5 5 5 5 5 5 5 5 5 5 5 5 5 5 5 5 5 5 5 5 5 5 5 5 5 5 5 5 5 5 5 5 5 5 5 5 5 5 5 5 5 5 5 5 5 5 5 5 5 5 5 5 5 5 5 5 5 5 5 5 5 5 5 5 5 5 5 5 5 5 5 5 5 5 5 5 5 5 5 5 5 5 5 5 5 5 5 5 5 5 5 5 5 5 5 5 5 5 5 5 5 5 5 5 5 5 5 5 5 5 5 5 5 5 5 5 5 5 5 5 5 5 5 5 5 5 5 5 5 5 5 5 5 5 5 5 5 5 5 5 5 5 5 5 5 5 5 5 5 5 5 5 5 5 5 5 5 5 5 5 5 5 5 5 5 5 5 5 5 5 5 5 5 5 5 5 5 5 5 5 5 5 5 5 5 5 5 5 5 5 5 5 5 5 5 5 5 5 5 5 5 5 5 5 5 5 5 5 5 5 5 5 5 5 5 5 5 5 5 5 5 5 5 5 5 5 5 5 5 5 5 5 5 5 5 5 5 5 5 5 5 5 5 5 5 5 5 5 5 5 5 5 5 5 5 5 5 5 5 5 5 5 5 5 5 5 5 5 5 5 5 5 5 5 5 5 5 5 5 5 5 5 5 5 5 5 5 5 5 5 5 5 5 5 5 5 5 5 5 5 5 5 5 5 5 5 5 5 5 5 5 5 5 5 5 5 5 5